code	name
en	English
da	Dansk
de	Deutsch
en-gb	English - UK
es	Español - España
es-mx	Español - Latinoamérica
fr	Français
it	Italiano
hu	Magyar
nl	Nederlands
no	Norsk
pl	Polski
pt	Português
pt-br	Português - Brasil
ro	Română
sk	Slovenčina
fi	Suomi
sv	Svenska
vi	Tiếng Việt
tr	Türkçe
cs	Čeština
el	Ελληνικά
bg	Български
ru	Русский
th	ภาษาไทย
zh-cn	中文 简体
zh-tw	中文 繁體
ja	日本語
ko	한국어