code	name
en	English
af	Afrikaans
am	Amharic
ar	Arabic
hy	Armenian
as	Assamese
az	Azerbaijani
eu	Basque
be	Belarusian
bn	Bengali
bs	Bosnian
bg	Bulgarian
my	Burmese
ca	Catalan
km	Central Khmer
zh	Chinese (Simplified)
hr	Croatian
cs	Czech
da	Danish
nl	Dutch
et	Estonian
fil	Filipino
tl	Filipino
fi	Finnish
fr	French
gl	Galician
ka	Georgian
de	German
el	Greek, Modern
gu	Gujarati
he	Hebrew
hi	Hindi
hu	Hungarian
is	Icelandic
id	Indonesian
it	Italian
ja	Japanese
kn	Kannada
kk	Kazakh
ky	Kirghiz
ko	Korean
lo	Lao
lv	Latvian
lt	Lithuanian
mk	Macedonian
ms	Malay
ml	Malayalam
mr	Marathi
mn	Mongolian
ne	Nepali
se	Northern SÃ¡mi
no	Norwegian
or	Oriya
fa	Persian
pl	Polish
pt	Portuguese
pa	Punjabi
ro	Romanian
ru	Russian
sq	Sango
sr	Serbian
si	Sinhala
sk	Slovak
sl	Slovenian
es	Spanish
sw	Swahili
sv	Swedish
ta	Tamil
te	Telugu
th	Thai
tr	Turkish
uk	Ukrainian
ur	Urdu
uz	Uzbek
vi	Vietnamese